16 16
1111111111111111
1000000000000001
1020202002020201
1000000000000001
1020000000000201
1000000000000001
1020000110000201
1000001111000001
1000001111000001
1020000110000201
1000000000000001
1020000000000201
1000000000000001
1020202002020201
1000000000000001
1111111111111111