17 17
11111111111111111
10001000001000001
11101011101010111
10001000100010001
10111110111111101
10000000000010001
10111111111110101
10101000100000101
10101010101111101
10101010001000101
10101011111010101
10001000001010001
11101111101011111
10100010101010001
10111010101111101
10000000100000001
11111111111111111